4
5
13101
10101
10101
10121
00000
5
13101
10101
10101
10101
10021
5
10031
10111
10101
10101
12001
5
00003
01110
01000
01111
00002
